a a a a a a a a a a a a a a a a a a a a a a a a a a a a a a a a a a a a a a a
a a a a a a a a a a a a a a a a a a a a a a a a a a a a a a a a a a a a a a a
d f d d d d a a a a a a a a a a a a a a a a a a a a a a a a a a a a a a a a a
a a a a a d d d d d d d d f d d d d d d d d f d d d d d d d d d d f d d d d d
a a a a a a a a a a a a a a a a a a a a a a a a a a a a a a a a a a a a a a a
a a a a a a a a a a a a a a a a a a a a a a a a a a a a a a a a a a a a a a a
d d d d f d d d d d a a a a a a a a a a a a a a a a a a a a a a a a a a a a a
a a a a a a a a a a a a a a a a a a a a a a a a a a a a a a a a a a a a a a a
a a a a a a a a a a a a a a a a a a a a a a a a a a a a a a a a a a a a a a a
a a a a a a a a a a a a a a a a a a a a a a a a a a a a a a a a a a a a a a a
d d d d d d d d d f d d d d d d d d d d d d d d f d d d d d d d d d d f d d d
a a a a a a a a a a a a a a a a a a a a a a a a a a a a a a a a a a a a a a a
d d d f d d d d d d d d f d d d d d d d d f d d d d d a a a a a a a a a a a a
a a a a a a a a a a a a a a a a a a a a a a a a a a a a a a a a a a a a a a a
a a a a a a a a a a a a a a a a a a a a a a a a a a a a a a a a a a a a a a a
a a a a a a a a a a a a a a a a a a a a a a a a a a a a a a a a a d d d d f d
a a a a a a a a a a a a a a a a a a a a a a a a a a a a a a a a a a a a a a a
d d d d d f d d d d d d d d d f d d d d d d d d d d d f d d d d d a a a a a a
a a a a a a a a a a a a a a a a a a a a a a a a a a a a a a a a a a a a a a a
d d d d d d d d f d d d d d d d d d d f d d d d d d d d d d d d d d f d d d d
a a a a a a a a a a a a a a a a a a a a a a a a a a a a a a a a a a a a a a a
a a a a a a a a a a a a a a a a a a a a a a a a a a a a a a a a a a a a a a a
a a a a a a a a a a a a a a a a a a a a a a a a a a a a a a a a a a a a a a a
d d d d d f d d d d d d d d d f d d d d d d d d d f d d d d d d d d f d d d d
a a a a a a a a a a a a a a a a a a a a a a a a a a a a a a a a a a a a a a a
a a a a a a a a a a a a a a a a a a a a a a a a a a a a a a a a a a a a a a a
a a a a a a a a d d f d d d d d d d d f d d d d d d d d f d d d d d d d d d d
a a a a a a a a a a a a a a a a a a a a a a a a a a a a a a a a a a a a a a a
a a a a a a a a a a a a a a a a a a a a a a a a a a a a a a a a a a a a a a a
a a a a a a a a a a a a a l a l a a a a a a a a l a a a a a l a a a a a a l a
d d d d f d d d d d d d f d d d d d d d d f d d d d d d d d d d f d d d d d d
a a a a a a a a a a j a k a a a a a j a a a a a j k a a a a a a j a a k a a a 
a a a a a a a a a a a a a a a a a a a a a a a a a a a a a a a a a a a a a a a 