a a a a a a a a a a a a a a a a a a a a a a a a a a a a a a a a a a a a a a a a
a a g h a a a a a a a a a a a a g h a a a a a a a a g h a a a a a a a a a a a a
a a a a a a a a a a a a a a a a a a a a a a a a a a a a a a a a a a a a a a a a
a a a a a a a a a a a a a a a a a a a a a a a a a a a a a a a a a a a a a a a a
a a a a a a a a a a a a a d d d d d d d d f d d d d d d d d d d d d d f d d d d
d d d d d d d d d d d d d a a a a a a a a a a a a a a a a a a a a a a a a a a a
a a a a a a a a a a a a a a a a a a a a a a a a a a a a a a a a a a a a a a a a
a a a a a a a a a a a a a a a a a a a a a a a a a a a a a a a a a a a a a a a a
a a a a a a a a a a a a a a a a a a a a a a a a a a a a a a a a a a a a a a a a
d d d d d d d d d d d d d d d d d d d d d f d d d d d d d d d d d d d f d d d d
a a a a a a a a a a a a a a a a a a a a a a a a a a a a a a a a a a a a a a a a
a a a a a a a a a a a a a a a a a a a a a a a a a a a a a a a a a a a a a a a a
a a a a a a a a a a a a a a a a a a a a a a a a a a a a a a a a a a a a a a a a
d d d d d d d d d d d d d d d d d d d d d f d d d d d d d d d d d d d f d d d d
a a a a a a a a a a a a a a a a a a a a a a a a a a a a a a a a a a a a a a a a
a a a a a a a a a a a a a a a a a a a a a a a a a a a a a a a a a a a a a a a a
d d d d d d d d a a a a a a a a a a a a a a a a a a a a a a a a a a a a a a a a
a a a a a a a a a a a a a a a a a a a a a a a a a a a a a a a a a a a a a a a a
a a a a a a a a a a a a a a a a a a a a a a a a a a a a a a a a a a a a a a a a
d d d d d d d d d d d d d d f d d d d d d d d d d d d d d f d d d d d d d d d d
a a a a a a a a a a a a a a a a a a a a a a a a a a a a a a a a a a a a a a a a
a a a a a a a a a a a a a a a a a a a a a a a a a a a a a a a a a a a a a a a a
a a a a a a a a a g h a a a a a a a a a a a a a a a a a a a a a a a a a a a a a
d d d d d d d d d d d d d d d d d d d d d f d d d d d d d d d d d d d f d d d d
a a a a a a a a a a a a a a a a a a a a a a a a a a a a a a a a a a a a a a a a
a a a a a a a a a a a a a a a a a a a a a a a a a a a a a a a a a a a a a a a a
a a a g h a a a a a a a a a a a a a a a a a a a a a a a a a a a a a a a a a a a
d d d d d d d d d d d d d d f d d d d d d d d d d d d d d f d d d d d d d d d d
a a a a a a a a a a a a a a a a a a a a a a a a a a a a a a a a a a a a a a a a
a a a a a a a a a a a a a a a a a a a a a a a a a a a a a a a a a a a a a a a a