a a a a a a a a a a a a a a a a a a a a a a a a a a a a a a a a a a a a a a a a
a v v v v v v v v v v v v v v v v v v v v v v v v v v v v v v v v v v v v v v a
a v v v v v v v v v v v v v v v v v v v v v v v v v v v v v v v v v v v v v v a
a v v v v v v v v v v q v v v v v v v v v v v v v v v v v v v v v v v v v v v a
a v v v v v v v v h a a a i v v v v v v v v v v v v v v v v v v v v s v t v v a
a v v v v v v v v v k a a a i v v v v v r v v v v v h a a a i v v v v v v v v a
a v v r v v v v v v v a a a a a a a a a a a a a a a a a a a a a a a a a a a a a
a a a a a a v v v v v a a a a a v v v v v v v v v v v v v v v v v v v v v v v a
a a a a a a v v v v v a a a a a v v v v v v v v v v v v v v v v v v v v v v v a
a a a a a a v v v v v v v v v v v v a a a a a a a a v v v v v v v v v v v v v a
a a a a a a v v v v v v v v v v v v a a a a a a a a v v v v v v v v v v v v v a
a a a a a a a a a a a a a a a a a a a a a a a a a a a a a a a a a a a v v v v a
a v v v v v v v v v v v v v v v v v v v v v v v v v v v v v v k a a a a v v v a
a v v v v v v v v v v v v v v v v v v v v v v v v v v v v v v v v v v v v v v a
a v v v v v v v v v v q v v v v v v v v v v v v v v r v v v v v v v v v v v v a
a v v v v v v v v a a a a a a a a a a a a v v v a a a a a a a v v v v v v v v a
a v v v v v v v a a v v v v v v v v v a a a a a a v v v v v a a a a a a a a a a
a v v v v v v a a v v v v v v v v v v v v v v v v v v v v v v v v a a a a a a a
a v v v v v v v v v v v v v v v v v v v v v v v v v v v v v v v v v v a a a a a
a v v v v v v v v v v v v v v v v v v v v v v v v v v v v v v v v v v v a a a a
a v v v v v v v v v v v v v v v v v v v v v v v v v v v v v v v v v v v v v v a
a a a a a a a a a a a a a a a a a a v v v v v v v v v v v v v v v v v v v v v a
a v v v v v v v v v v v v v v v k a a a a a a a a l m m m n a a a a i v v v v a
a v p v v v v v v v v v v v v v v v v v v v a a a v v v v v v v v v v v v v v a
a v v v v v v v v v v v v v v v v v v v v v v v v v v v v v v v v v v v v v v a
a a a a a a a a a a a a a v v v v v v r v v v v v v v q v v v v v v v v v v v a
a v v v v v v v v v v v v v v v v v v v v v v v v v v v v v v v v v a a a a a a
a v o v v v v v v v v v v v v v v v v v v v v v v v v v v v v v v v a a a a a a
a v v v v v v v v v v v v v v v v v v v v v v v v v v v v v v v v v a a a a a a
a a a a a a a a a a a a a a a a a b c c c d a a a e f f f g a a a a a a a a a a