v v v v v v v v a a a a a a a a a
v v v v v v v v a v v v v v v v a
v v v v v v v v a v v v v v v v a
a a a a a a a a a v v v v v v v a
a v v v v v v v v v v v v v v v a
a v v v v v v v v v v v v v v v a
a v v v v v v v v v v v v v v v a
a v v v v v v v v v v v v v a a a
a v v v v v v v v v v a v v a a a
a a a a a a a l m n a a a a a a a