a a a a a a a a a a a a a a a a a a a a a a a a a a a a a a a a a a a a a a a a
a v v v v v v v v v v v v v v v v v v v v v v v v v v v v v v v v v v v v v v a
a v v v v v v v v v v v v v v v v v v v v v v v v v v v v v v v v v v v v v v a
a v v v v v v v v v v v v v v v v v v v v v v v v v v v v v v v v v v v v v v a
a v v v v v v v v v v v v v v v v v v v v v v v v v v v v v v v v v v v v v v a
a a a a a a a a a a a a a a a a a a v v v v v a a a a a a a a a h v v v v v v a
a v v v v v v v v v v v v v v v v v v v v v v v v v v v v v a a a h v v v v v a
a v v v v v v v v v v v v v v v v v v v v v v v v v v v v v v a a a a v v v v a
a v v v v v v v v v v v v v v v v v v v v v v v v v v v v v v v v v v v v v v a
a v v v v v v v v v v v v v v v v v v v v v v v v v v v v v v v v v v v v v v a
a v v v v v v v v v v v v v v v v v v v v v v v v v v v v v v v v v v v a a a a
a v v v v v v v v v v v v v v v v v v v v v v v v v v v v v v v v v v v a a a a
a v v v v v v v v v v v v v v v v v v v v v v v v v v v v v v v v v v v a a a a
a v v v v v v v v v v v i h v v v v v v v v v v v v i h v v v v v v a a a a a a
a v v v v v v v v v v v v v v v v v v v v v v v v v v v v v v v v v a a a a a a
a v v v v v v v v v v v v v v v v a a a a a v v v v v v v v v v v v a a a a a a
a v v v v v a a l m m m m m m m n a a a a a l m m m m m m m n a a a a a a a a a
a v v v v v v v v v v v v v v v v v v v v v v v v v v v v v v v v v v v v v v a
a a a a v v v v v v v v v v v v v v v v v v v v v v v v v v v v v v v v v v v a
a a a a v v v v v v v v v v v v v v v v v v v v v v v v v v v v v v v v v v v a
a a a a v v v v v v v v v v v v v v v v v v v v v v v v v v v v v v v v v v v a
a a a a a a a a a a a a a a a a a a a a a a a a a a a a a a a a a a a h v v v a
a v v v v v v v v v v v v v v v v v v v v v v v v v v v v v v v v v v v v v v a
a v v v v v v v v v v v v v v v v v v v v v v v v v v v v v v v v v v v v v v a
a v v v v v v v v v v v v v v v v v v v v v v v v v v v v v v v v v v v v i a a
a v v v v v v e f f f f f f f v v v v v v v v b c c c c c c c d v v v v i a a a
a v o v v v v v v v v v v v v v v v v v v v v v v v v v v v v v v v v v a a a a
a v v v v v v v v v v v v v v v v v v v v v v v v v v v v v v v v v v v a a a a
a a a a a a a b c c c c c c c d a a a a a a a e f f f f f f f g a a a a a a a a