v v v v v v v v a a a a a a a a a a a a a a a a a a a
v v v v v v v v a v v v v v v v v v v v v v v v v v a
v v v v v v v v a v v v v v v v v v v v v v v v v v a
a a a a a a a a a v v v v v v v v v v v v v v v v v a
a v v v v v v v v v v v v v v v v v v v v v v v v v a
a v v v v v v v v v v v v v v v v v v v v v v s v t a
a v v v v v v v v v v v v v v v v q v r v v v v v v a
a v o p v v v v v v v v v v a a a a a a a a a a a a a
a v v v v v v v v v v v v v a v v v v v v v v v v v a
a a a a a a a b c d a a a a a a a a a a a a a a a a a