v v v v v v v v a a a a a a a a a a a a a a a
v v v v v v v v a v v v v v v v v v v v v v a
v v v v v v v v a v v v v v v v v v v v v v a
a a a a a a a a a v v v v v v v v v v v v v a
a v v v v v v v v v v v v v v v v v v v v v a
a v v v v v v v v v v v v v v v v v v v v v a
a v v v v v v v v v v v v v v v v q v v v v a
a v o v v v v v v v v v v v a a a a a a a a a
a v v v v v v v v v v v v v a v v v v v v v a 
a a a a a a a b c d a a a a a a a a a a a a a 