a a a a a a a a a a a a a a a a a a a a a a a a a a a a a a a a a a a a a a a 
a a v v v a a a a v v v v v v v v v v v v v v v v v v v v v v v v v v v v v a
a v v v v v a a v v v v v v v v v v v v v v v v v v v v v v v v v v v v v v a
a a v v v a a v v v v v v v v v q v v v v v q v v v v v q v v v v v v o v v a
a a a a a a v v v v v v v v v v v v v v v v v v v v v v v v v v v v v v v a a
a a v v v v v v v a a a a v v v v v v v v v v v v v v v v v v v v a a a a a a
a v v v v q v v a a a a a a v v v v v a a v v v v a a v v v v v a a v v v a a
a v v v v v v a a a v v a a a e f f g a a e f f g a a e f f g a a v v v v v a
a v v a a a a a a v v v v v v v v v v v v v v v v v v v v v v v v v v v v v a
a v v v v v v v v v v v v v v v v v v v v v v v v v v v v v v v v v v v v v a
a v v v v v v v v v v v v v v v v v v v v v v v v v v v v v v v v v v v v v a
a v v v v v v v v v v v v v v v q v v v v v v v v q v v v v v v v a a a v v a
a v v v v v v v v v a a v v v v v v v v a a v v v v v a a a a v a a a a v v a
a a v v v v v v v a a a a v v v v v v a a a a v v v a a a a a a a v v a q v a
a a a a a a a a a a a a a a a e f g a a a a a a a a a a a a a a v v v a v v a
a j v v v v v v v v v v v v v v v v v v v v v v v v v v v a a a v v v a v v a
a v v v v v v v v v v v v v v v v v v v v v v v v v v v v v a a v v v v v v a
a v p v v v v v v v r v v v v v r v v v v v r v v v v v v v v a a a v v v a a
a a v v v v v v v v v v v v v v v v v v v v v v v v v v v v v v a a a a a a a
a a a a a a v v v v v v v v v v v v v v v v v v v v v v v v v v v v v v v a a
a j v v v a a v v v v v a a v v v v a a v v v v v a a a a a v v r v v v v v a
a v v v v v a a b c c d a a b c c d a a b c c d a a v v v a a v v v v v v v a
a v v v v v v v v v v v v v v v v v v v v v v v v v v v v v a a a a a a v v a
a v v v v v v v v v v v v v v v v v v v v v v v v v v v v v v v v v v v v v a
a v v v v v v v v v v v v v v v v v v v v v v v v v v v v v v v v v v v v v a
a v v a a a v v v v v v v v v v v v v v v v r v v v a a a a v v v v v v v v a
a v v a v a a v a a a a v v v v a a a v v v v v v a a a a a a v v v v v v v a
a v r a v v a a a a a a a v v a a a a a v v v v v a v v v v a a v v v v v a a
a v v a v v v v a v v v a a a a a v v a a b c d a a v v v v v a a a a a a a a
a v v a v v s v a v v v v v a v v v v v a a a a a a v v v v v a v v v v v v a
a v v v v v v v a v v v v v a v v v v v a v v v v a v v v v v a v v v v v v a
a a v v v v v v a v v v v v a v v v v v a v v v v a v v v v v a v v v v v v a
a a a a a a a a a a a a a a a a a a a a a a a a a a a a a a a a a a a a a a a