w w w w w w w w w w
w b b b b b b b b w
w b b b b b b b b w
w w w b w b b b b w
w b b b b b b b b w
w b b b b b d w w w
w w w l l w w w w w